111111111
1000P1
1C0001
100C01
1E001
111111111
