1111111111111111111111111111111111111111
1111111111111011111111111101111111111111
1111111111000101111111111010001111111111
1111111111001110111111110111001111111111
1111111111100110111111110110011111111111
1111111111100010011111100100011111111111
1111111111100001000000001000011111111111
1111111111100001001111001000011111111111
1111111111100000111111110000011111111111
1111111111110000111111110000111111111111
1111111111111001111101111001111111111111
1111111111111101111101111011111111111111
1111111111111001001001001001111111111111
1111111111111001001111001001111111111111
1111111111111000011111100001111111111111
1111111111110000000110000001111111111111
1111111111111000000110000000111111111111
1111111111111101000000000000111111111111
1111111111111110000000001011111111111111
1111111111111111111111000111111111111111
1111111111111111111111100111111111111111
1111111111111111111111111111111111111111